#########B#
#     # # #
# ##### # #
#         #
# #########
# #       #
# ####### #
#         #
# #########
#         #
#########A#