#########B#
#   #   # #
# # # # # #
# #   #   #
# #########
#         #
######### #
#         #
# #########
#         #
#########A#