#B############
#   #        #
# # # # # #  #
# # # ###### #
# #          #
#### ####### #
#    #       #
# #### #######
# #    #     #
# # #### #####
# #          #
# ########## #
#            #
############A#