##B#########
#    #     #
#    #     #
#          #
######## ###
#          #
#    #     #
#    #### ##
######     #
#    #     #
#          #
##########A#