#A###
#   #
# ###
#   #
### #
#   #
# ###
#####