######B#
#   #  #
#      #
# ######
#   #  #
#      #
# #### #
#  #   #
#      #
#####A##